#Verbs
する (Suru) – “To do”
です (Desu) – “To be” or “it is”
なる (Naru) – “To become”
ある (Aru) – “There is” for inanimate objects and plants.
いる (Iru) – “There is” for living things, like humans and animals.
言う (Iu) – “To say”
行く (Iku) – “To go”
出来る (Dekiru) – “To be able to do” or “can do”
見る (Miru) – “To see”
送る (Okuru) – “To send”
持つ (Motsu) – “To have” or “to hold”
待つ (Matsu) – “To wait”
会う (Au) – “To meet”
呼ぶ (Yobu) – “To call”
置く (Oku) – “To put”
受ける (Ukeru) – “To receive”
作る (Tsukuru) – “To make”
着く (Tsuku) – “To arrive”
使う (Tsukau) – “To use”
学ぶ (Manabu) – “To learn”
食べる (Taberu) – “To eat”
飲む (Nomu) – “To drink”
帰る (Kaeru) – “To return home”

#Adjectives
多い (Ooi) – “Many”
たくさん (Takusan) – “Lots of”
少し (Sukoshi) – “Few”
遠い (Tooi) – “Far”
近い (Chikai) – “Near”
小さい (Chiisai) – “Small”
大きい (Ookii) – “Big”
良い (Yoi) – “Good”
悪い (Warui) – “Bad”
きれいな (Kirei na) – “Clean” and “Pretty”
醜い (Minikui) – “Ugly”
難しい (Muzukashii) – “Difficult”
簡単な (Kantan na) – “Easy”
うまい (Umai) – “Nice”
美味しい (Oishii) – “Delicious”
まずい (Mazui) – “Disgusting”
大丈夫 (Daijoubu) – “All right”
すごい (Sugoi) – “Amazing”
楽しい (Tanoshii) – “Enjoyable” or “Pleasant”
とても (Totemo) – “Very”

#Conjunctions
しかし (Shikashi) – “However”
また (Mata) – “Also”
その後 (Sono ato) – “After that”
その時 (Sono toki) – “At that time”
場合は (Baai wa) – “If you” or “If this happens”
例えば (Tatoeba) – “For example”
それから (Sorekara) – “Then”
だから (Dakara) – “So”